5
5
2 3 0
1 1 3 4 5
1 0 0 0 5
1 0 0 0 5
1 0 0 0 5
1 2 3 4 5