16
16
2 3 0
001 001 001 001 002 001 001 001 001 001 001 001 001 001 001 001
001 100 000 000 000 000 100 001 000 000 000 000 000 000 000 001
001 000 000 000 000 000 000 001 000 000 000 000 000 000 000 001
001 000 000 000 000 000 000 001 000 000 000 000 000 000 000 001
001 000 000 000 000 000 000 001 000 000 000 000 000 000 000 001
001 000 000 000 000 000 000 001 000 000 000 000 000 000 000 001
001 100 000 000 000 000 100 001 000 000 000 000 000 000 000 001
001 001 001 001 000 001 001 001 000 000 000 000 000 000 000 001
001 001 000 000 000 000 000 001 000 000 000 000 000 000 000 001
001 000 000 000 000 000 000 001 000 000 000 001 000 000 000 001
001 000 000 000 000 000 000 000 000 000 000 000 000 000 000 001
001 000 000 000 000 000 000 001 000 000 000 000 000 000 001 001
001 000 001 000 000 000 000 001 000 000 000 000 000 000 001 001
001 000 001 000 000 000 000 001 000 000 000 000 000 000 000 003
001 001 001 001 001 001 001 001 001 001 001 001 001 001 001 001
